10x10* o12
*****2****
* *   **** 
*   **** *
* ****   * 
*  * oooo2
*  **o*  *
*  ooo* **
***o **  *
1ooo  ****
**********